Linus
緋月の狂想曲	Desire	Alicy	Echoes
烏	L'eternita	Magical 4	Chaos:Q
めうめうぺったんたん!!	黒髪乱れし修羅となりて	プロレタリア狂騒歌
おーまい！らぶりー！すうぃーてぃ！だーりん！	地方創生☆チクワクティクス	School Life	nalca
永遠という名の媚薬 ～Pyramid Power・Death Match ver.～	旗（Mystic Mix）	哀彩	Six String Proof
Daily Lunch Special	will	蒼が消えるとき	ボタン	鳳凰～Chinese Phoenix Mix～
繚乱ヒットチャート	BabeL ～Next Story～	一触即発☆禅ガール	World Spider Web	On top of the world
流星☆ハニー Perforation Mix	Engraved Mark	千年ノ理	リナリア
超恋愛☆エクストリーム・ガール	魔界！痛快！ヘルダンス	キャトられ♥恋はモ～モク	Angelic Jelly
ほしのつくりかた	ガッテンだ!!	徹頭徹尾Thrive at Perfect Fourth	ホピタスコピラ
Les Vague	Kicky Kemari Kicker	天上の星 ～黎明記～	Arcanos
アルストロメリア	怒れる大きな白い馬～S.S.D.の役～	ギターケンドー	GALAXY FOREST 11.6&12	乱れた風紀に天罰を
黒点	残像ニ繋ガレタ追憶ノHIDEAWAY	MOON	SPICY PIECE (Ryu☆Remix)	
西麻布水道曲	say...but in vain	INHERITANCE of WILL	曼珠沙華
おたすけ！アン子ちゃん (シノビアンレディーのテーマ 弐)	ゴールデンハート ft. Kimberley Nutbey	Candy Crime Toe Shoes	3 A.M. ディテクティブ・ゲーム	懐色坂
マイアガル、マイオドル	ウソツキ横丁は雨模様	玄兎ノ舞	μ9	"Schall" we step？	
Liar×Girl	Drizzly Venom	魂依	黒猫と珈琲	グランデーロの守り
表裏一体！？怪盗いいんちょの悩み♥	疾風	H@appy Fever Forever!!	532nm
ZEPHYRANTHES	The Zoo Zone	空想モダニズム -Alice Schach remix-	カタルシスの月	Afterimage d'automne
†渚の小悪魔ラヴリィ～レイディオ†	ノープラン・デイズ	High Gravity	左脳スパーク	空想モダニズム
TURBO BOOSTER	斑咲花	怒りと共に去りぬ！！	零と弌の鍵の唄
ラブケミ	マインド・ゲーム	SHION（VENUS mix）	SUPER SUMMER SALE
ドーナツホール	Bolide	001 -どうしんのかいろ-	巻寿司戦隊ウマイヤン ～コードネームはグリーン～
コルドバの女	星屑の夜果て	Phlox	Popperz Chronicle
The Sky of Sadness	storia	Psyche Planet-V
蒼氷のフラグメント	UNBOUND MIND	CARNIVOROUS	CARTOON☆RagHour	Pacify
鳥無き島にて	Amabie	恋はどう？モロ◎波動OK☆方程式!!	Stella Sinistra	MADSPEED狂信道
Tripping Jumping	装填昇天エクソシスト	Riot of Color	ミラクル・スイート・スイーツ・マジック！！	√太陽系◎ドーナツ化計画∞∀∞
シャムシールの舞	Windy Fairy	ブルーローズイノセンス	Shades of Day	勇猛無比
浅見文彦の事件簿～迷宮荘のワンピース	辞世テンプレート	ぼくらの16bit戦争	Red Cape Theorem	HYENA
チルノのパーフェクトさんすう教室	EBONY & IVORY	Symsonic Breeze	beat it together	ポチコの幸せな日常
Greening	不可説不可説転	REFLEXES MANIPULATION	BLSTR	Colors
ホムンクルスレシピ	水月鏡花のコノテーション	つばめ	Strawberry Chu♡Chu♡
Struggle	Miracle 4	狂水一華	LOTUS	Deep Magenta
demolizione	coffee break	Engraved on my heart ft. 小林マナ	Soul On Fire
路男	MA・TSU・RI	ランカーキラーガール	HADROS GALE
無意識のフィロソフィア	Akash	Butter-FLY	HAGURUMA
pure	プリンシプル	Over Da Moon	明日への誓い
Gradation	東京メモリー	Cassandra	ナスカの丘	GET WILD
Crumble Soul	Synergy For Angels	Cloud 9	残酷な天使のテーゼ	黒き螺旋のクレイドル
アルレシャ	Sword of Vengeance	mathematical good-bye	TOXIC VIBRATION
禁じられた契約	ペリーでぇす！	ココロコースター	Fly far bounce	
サヨナラ・ヘヴン	人妖絵巻其の二「鬼」～夜叉の祭は終夜～	ネリと琥珀糖	TAKE YOU AWAY
コンビニエンスドラマ	取り残された美術(Arranged:HiZuMi)	Welcome to pop'n fantasy	IKKI! Explosion	麗破唖甦～rebirth～
Blind	Little Little Princess	脳漿炸裂ガール	Shining Wizard	SPEED KING ON FIRE
High Speed Junkie!	Heavenly Good Morning!	Scarlet Pinheel	CURUS	Dimension Gale
Lovin' You	洟・月・奇蹟	青春の扉	恋愛観測 -Rock Band Ver.-
チョコレートスマイル	どうなっちゃったって	幸せを謳う詩	Into The Light
Come to Life	朱と碧のランページ	星屑ブレスレット
Megalara Garuda	電波の暮らし	アンデスの太陽	NEW PEOPLE	そこはかとなくロマンセ
Denpasar	Sweet,Sweet,Sweet.	パーフェクトイーター	Gotta Get My Groove On	paparazzi	
蒼い弓箭	Ensamble Forecast 3/28	De-a lungul vietii	Pure Rude	Poppin' Soda
brave!	BEEF	六兆年と一夜物語	レトロスペクト路	Inside Insight
凛として咲く花の如く	霽れと褻と穢れ	桃花恋情	憂恋☆アクティベーション	SESSION With You!
恋とメロンとキューピット	滅びに至るエランプシス	夢幻ノ光
キルト	ABSOLUTE	異能対決！VS.淀ジョル	ラピストリアの約束
結果オーライ！相性チェック
GO²TOS
まっぷたツートンソウル	すすめ！キッチンカー	Little Rock Overture	ワカンナイト☆フィーバー！？
Surfing Area51	DOKIDOKI☆シューティングスター	轟け！恋のビーンボール！！ (STARDOM Remix)	あるビー！ feat.ころねぽち	キセキはじまり☆