ハラショー！おにぎりサーカス団☆	Dogu Ditty	嘆きの樹 (BEMANI SYMPHONY Arr.)	Mynarco	chilblain
在るが儘に	天和無双	へんたいトリロジー	Journey	
猫侍の逆襲	murmur twins	Stories	50th Memorial Songs -The BEMANI History-	
BILLION MONEY BAZOOKA	Dance to Blue (Respect Style)	♥LOVE² シュガ→♥ (かめりあ&ななひら's Over-Sweet-Dempa ♥LOVE² シュガ→♥な恋愛教室 Remix)	めうめうぺったんたん！！ (ZAQUVA Remix)
virkatoの主題によるperson09風超絶技巧変奏曲	Τέλος
黒髪乱れし修羅となりて～凛 edition～	The last of world music	nostos
焔華	元禄花吹雪	ミサコの日記（見ちゃダメ！）
ホーンテッド★メイドランチ	Bye Bye	鳳凰～Chinese Phoenix Mix～	Shout It Out	六花美人
猿の経	La Lumiere	ほおずき程度には赤い頭髪	うた	
Miracle 4 RELOADED	天空ジオグラフィ	オッタマゲッター	この子の七つのお祝いに	
でんがなマンガナ	smile	full-consciousness green	差無来！！
ちくわパフェだよ☆ＣＫＰ	地方創生☆チクワクティクス	焱影	クラゲータ	エキサイティング！！も・ちゃ・ちゃ☆
永遠という名の媚薬	For Dear ～	お米の美味しい炊き方、そしてお米を食べることによるその効果。	PUNISHER	αρχη
カタルシスの月	Pa la la 42	BBLLAASSTT!!	男々道	quaver♪
Revived After Ruined Shine	キリステゴメン	fallen leaves -IIDX edition-	放課後コンチェルティーノ～私だけの部室狂騒曲	Amalgamation
ませまてぃっく♥ま+ま=まじっく！	Treasure Hoard	Der Wald(kors k Remix)	ON-DO
文明開化	KIMONO♥PRINCESS	乞い祈みの撫子	Fate No.23
ACCELERATION	Craze for You	バンブーソード・ガール	Head Scratcher	Spiral Clouds
Visterhv	怒れる大きな白い馬	Caradbolg	一触即発☆禅ガール
朧月覆う雲をも裂きぬ	LIKE A VAMPIRE	Russian Caravan Rhapsody	perditus†paradisus	unisonote
造花の貌	少年リップルズ	PITAゴラス☆KISS	弾幕信仰	Versa
ススメ！少年！！	Maritare!	Nove Primavere	突然ゴルゴンゾーラ
螺子之人	KING of the SEA	I just hate you	Violently Car	NINE PIECE
popcorn parade	カゲロウ	El venenciador	背水之陣	SDVX REMIX SELECTION for pop'n music vol.01
龍と少女とデコヒーレンス	もうあおむけでいくしかない	僕らの旅はどこまでも	薔薇は永遠に美しく
セツナトリップ	Sweet Sweet ♥ Magic	FLOWER	LIMIT TOPPA REVOLUTION	踊るフィーバーロボ　Eu-Robot mix
白夜幻燈	キルト（Patchworker RMX）	天庭	Aftermath	サケビノミドリ
INFINITY	暴レ焔	たまゆら	水晶塔のオルカ	彼女は快刀乱麻
ストレイ・マーチ	Mychronicle	Stylus	ムーニャポヨポヨスッポコニャーゴ	The tyro's reverie
speedstar[02]	TRUTH behind U	ジオメトリック∮ティーパーティー	Manhattan Sports Club
UROBOROS OVERDIVE	デパ地下のお話	スーパーモグー	情操ディストピア
Monkshood	ice crystals	Holy Forest	virtual killer
コルトーン	SPACE CRASH LANDING	Votum stellarum -forest #25 RMX-	HypArcSin(x)	Squeeze
Floccinaucinihilipilification	フリーパス	Double Dribble	BEYOND THE EARTH	Amulet of Enbarr
ヴェルヴェット　バレット	情熱タンデムRUNAWAY	V	Levitation Minneapolis	ISERBROOK
Ge-Ko-Ku-Jo	誰がために陽はのぼる	恋する☆宇宙戦争っ！！	エイプリルフールの唄	ユメブキ
一発逆転！××だらけのハッピー大運動会！！	煌-灼熱の裁き-	極悪の華
8000000	お江戸花吹雪 TEYAN-day MIX	STERLING SILVER	十界
明鏡止水	On dish or maindish?	天庭 おとこのこ編	Hatcha Metcha Party
己経忍不住了	Reconsideration	IMPLANTATION	Invisible Farewell
乙女繚乱 舞い咲き誇れ	叛逆のディスパレート	地の記　獄編	Swinging Skulls	The Die is cast.
雷君	Cleopatrysm	ポルターガイスト	PRANA	なまいきプリンセス	
DOES NOT COMPUTE	Habits	デュスノミア	AsiaN distractive
I'm so Happy	革命パッショネイト	BLAZE∞BREEZE	Jack in the Box
断罪プラズマ	凛として咲く花の如く　～ひなビタ♪edition～	鴉	Catch Our Fire!
黎明スケッチブック	In The Ruins	Princess Roki	Romance
けもののおうじゃ★めうめう	世界の果てに約束の凱歌を-pop'n ver.-	ATTRACTION！	真超深ＴＩＯＮ	Jetcoaster Windy
1/6billionth	神曲	漆黒のスペシャルプリンセスサンデー	Little prayer
月光蝶	Ancient Heritage	Peragro	メンテナンス物語
銃弾は解を撃ち抜いて	Slime Molds	Celsus	THE SAFARI - NEETs ver. -
如雨露姫が世界征服	Empty Backdoor
Danza Pantera
Electronic or Treat!	ハートのフリット	Cookie Bouquets	astral_dismantle