Versa
POP-STEP-UP
創世ノート	雪上断火	路男	多極性ニューロンの崩壊による人間の末路	Leaf
Trixxxter	Vairocana	Red Roses	バイキングマン	ULTRA BUTTERFLY（坤剛力）
LEAD Gravity(M)	子供の落書き帳
STULTI	御千手メディテーション	GAIA	序
背水之陣(Kagutsuchi Remix)	Metamorphose	Evans	OVERHEAT -Type P-
SOLID STATE SQUAD -RISEN RELIC REMIX-	背徳と邪悪のエピタフ	NOBUNAGA	ポチコの幸せな日常 (狂犬U`x´UばうわうHARDCORE Remix)	ホーンテッド★メイドランチ
Grand Chariot	進め！爺ちゃん！	Globe Glitter	
CHIP'N RIDDIM	恋はどう？モロ◎波動OK☆方程式！！	voltississimo
hora de verdad	蟲の棲む処	灰の羽搏	Chronoxia
DDR MEGAMIX	左脳スパーク	テンプラ揚三	SYMPHONY FROM ZERO
nostos	JOMANDA	ZADAMGA
Raison d'être～交差する宿命～	ポルターガイスト	Macuilxochitl	リリーゼと炎龍レーヴァテイン
天ぷらイントロドン！！	灼熱Beach Side Bunny	Alia Dimensiva	令和の国
Gabbalungang	踊るフィーバーロボ	霖が哭く	BabeL ～Grand Story～
金縛りの逢を	魔法のかくれんぼ	MADSPEED狂信道
fffff	Sanctum Crusade	Life is beautiful	カラルの月	煉獄事変
混乱少女♥そふらんちゃん!!	Concertare	Dimensiva Vulnus	KETER	乙女繚乱 舞い咲き誇れ
MEGALOVANIA	Concertino In Blue	Trill auf G	Esperanza
革命パッショネイト	fffff op.2	good night , mommy	コドモライブ	Gray clouds
GOLDEN CROSS	Valanga	ミサコの告白(みーつけたっ♥)	万物快楽理論	あまるがむ
満漢全席火花ノ舞	夜間行	翠雨の祷	Battle Against a True Hero/本物のヒーローとの戦い
人妖絵巻其の三「鴉天狗」～ 鞍馬のHAYATE ～	Russian Caravan Rhapsody	ZETA～素数の世界と超越者～
Little prayer	Idola	Funky sonic World
火風陸空	Dracophobia	流離	雫	ただ、それだけの理由で
Mirage Age	FLOWER	Hexer	DUAL STRIKER	現代のヘイヨエ祭り	
蛇神	祭ノ痕、君ヲ憶フ。	たまごの物理科学的 及び調理特性に関しての調査、そしてその考察	カラフルトイズ・ワンダーランド	スーパー戦湯ババンバーン	
saQrifice	cucumis melo	Majestaria	風林火山
Ergosphere	野獣ワイルド	Doll's sight
La fame di Adria	轟け！恋のビーンボール！！	夢について TYPE C	Warriors Aboot
少女と時の花	輪廻の鴉	Indigo Nocturne
生きてこそ～特別版～	ANNIVERSARY ∴∵∴ ←↓↑→	量子の海のリントヴルム
霊魂爆砕 -SOUL EXPLOSION-	Northern Cross
カーニバルの主題による人形のためのいびつな狂想曲	Puberty Dysthymia	龍王の霊廟(Mausoleum Of The Primal Dragon)
Southern Cross	賢聖シリウスの采配	MVA
一激必翔	海神	asteer	西軍｜｜∴⊂SEKIGAHARA⊃∴｜｜東軍
青天ノ霹レキ	forever under construction
The Least 100sec	True Blue	Celsus II	Xジェネの逆襲
Aithon
encounter	閉塞的フレーション
夜虹	TYPHØN	Knockin' on Red Button	The Metalist	Jazz is Rad
ちくわパフェだよ☆CKP (Yvya Remix)	狼弦暴威	遊戯大熊猫	少年A	Dragon Blade -The Arrange-