LEAD Gravity（M）	テンプラ揚三
カラルの月	バイキングマン	創世ノート
夜間行	ポチコの幸せな日常 (狂犬U`x´UばうわうHARDCORE Remix)	Versa	SYMPHONY FROM ZERO
Leaf	蟲の棲む処	voltississimo
POP-STEP-UP	Globe Glitter	灼熱Beach Side Bunny
fffff op.2	背水之陣 (Kagutsuchi Remix)	祭ノ痕、君ヲ憶フ。	Trixxxter
ULTRA BUTTERFLY(坤剛力)	Doll's sight	雫	La fame di Adria
BabeL 〜Grand Story〜	nostos	Alia Dimensiva	OVERHEAT -Type P-
踊るフィーバーロボ	あまるがむ	リリーゼと炎龍レーヴァテイン	Grand Chariot
Evans	序	Sanctum Crusade
MADSPEED狂信道	Dimensiva Vulnus	子供の落書き帳
混乱少女♥そふらんちゃん!!	御千手メディテーション	Yum Yum OYACHU	令和の国
asteer	Red Roses	人妖絵巻其の三「鴉天狗」〜 鞍馬のHAYATE 〜	ZADAMGA
背徳と邪悪のエピタフ	ホーンテッド★メイドランチ	CHIP'N'RIDDIM	The Metalist
少女と時の花	翠雨の祷	野獣ワイルド	Metamorphose
Puberty Dysthymia	霖が哭く	Jazz is Rad	GAIA
万物快楽理論	Vairocana	煉獄事変	Funky sonic World
Trill auf G	カラフルトイズ・ワンダーランド	hora de verdad	DDR MEGAMIX
Life is beautiful	魔法のかくれんぼ	遊戯大熊猫	Chronoxia
Macuilxochitl	金縛りの逢を	Esperanza	STULTI
進め！爺ちゃん！	霊魂爆砕 -SOUL EXPLOSION-	ちくわパフェだよ☆ＣＫＰ (Yvya Remix)	灰の羽搏
MEGALOVANIA	MVA	Raison d'être〜交差する宿命〜	JOMANDA
ポルターガイスト	Concertino In Blue	cucumis melo	多極性ニューロンの崩壊による人間の末路
SOLID STATE SQUAD -RISEN RELIC REMIX-	現代のヘイヨエ祭り	fffff	流離
Dracophobia	Majestaria	ミサコの告白（みーつけたっ♥）	火風陸空
天ぷらイントロドン！！	コドモライブ	FLOWER	Gray clouds
Dragon Blade -The Arrange-	なまいきプリンセス	路男	ZETA〜素数の世界と超越者〜	Northern Cross
賢聖シリウスの采配	Mirage Age	GOLDEN CROSS	good night , mommy
カーニバルの主題による人形のためのいびつな狂想曲	Ergosphere	轟け！恋のビーンボール！！	saQrifice
DUAL STRIKER	Idola	乙女繚乱 舞い咲き誇れ	雪上断火
スーパー戦湯ババンバーン	forever under construction	Battle Against a True Hero/本物のヒーローとの戦い	Warriors Aboot
Concertare	風林火山	輪廻の鴉	Southern Cross
KETER	ただ、それだけの理由で	狼弦暴威	たまごの物理科学的 及び調理特性に関しての調査、そしてその考察
Russian Caravan Rhapsody	西軍||∴⊂SEKIGAHARA⊃∴||東軍	Gabbalungang	恋はどう？モロ◎波動OK☆方程式！！
ANNIVERSARY ∴∵∴ ←↓↑→	少年A	左脳スパーク	Hexer
Indigo Nocturne	Valanga	Knockin' on Red Button	一激必翔
TYPHØN	夢について　TYPE C	Celsus Ⅱ	青天ノ霹レキ
量子の海のリントヴルム	満漢全席火花ノ舞	Little prayer	蛇神
encounter	Xジェネの逆襲	龍王の霊廟(Mausoleum Of The Primal Dragon)	生きてこそ〜特別版〜
True Blue	The Least 100 sec	海神	夜虹
NOBUNAGA	Aithon	革命パッショネイト	閉塞的フレーション